000CCCCCCIIII00000CCCCCCIIII00000CCCCCCIIII00000CCCCCCIIII00000CCCCCCI
CCCCCCIIII00000CCCCCCIII00000CCCCCIIII00000CCCCCCIIII00000CCCCCCIIII00
000CCCCCCIIII00000CCCCCCIIII00000CCCCCCIIII00000CCCCCCIIII00000CCCCCCI
CCCCCCIIII00000CCCCCCIII00000CCCCCIIII00000CCCCCCIIII00000CCCCCCIIII00
000CCCCCCIIII00000CCCCCCIIII00000CCCCCCIIII00000CCCCCCIIII00000CCCCCCI
CCCCCCIIII00000CCCCCCIII00000CCCCCIIII00000CCCCCCIIII00000CCCCCCIIII00
000CCCCCCIIII00000CCCCCCIIII00000CCCCCCIIII00000CCCCCCIIII00000CCCCCCI
CCCCCCIIII00000CCCCCCIII00000CCCCCIIII00000CCCCCCIIII00000CCCCCCIIII00
000CCCCCCIIII00000CCCCCCIIII00000CCCCCCIIII00000CCCCCCIIII00000CCCCCCI
CCCCCCIIII00000CCCCCCIII00000CCCCCIIII00000CCCCCCIIII00000CCCCCCIIII00
000CCCCCCIIII00000CCCCCCIIII00000CCCCCCIIII00000CCCCCCIIII00000CCCCCCI
CCCCCCIIII00000CCCCCCIII00000CCCCCIIII00000CCCCCCIIII00000CCCCCCIIII00
000CCCCCCIIII00000CCCCCCIIII00000CCCCCCIIII00000CCCCCCIIII000022222222
CCCCCCIIII00000CCCCCCIII00000CCCCCIIII00000CCCCCCIIII00000CCHHHH55G5H5
000CCCCCCIIII00000CCCCCCIIII00000CCCCCCIIII00000CCCCCCIIII000005555555
CCCCCCIIII00000CCCCCCIII00000CCCCCIIII00000CCCCCCIIII000HG5HG5GG5H5GG5
000CCCCCCIIII00000CCCCCCIIII00000CCCCCCIIII00000CCCCCCI555555555555555
CCCCCCIIII00000CCCCCCIII00000CCCCCIIII00000CCCCCCIIII00000CG5H5G5G5G55
000CCCCCCIIII00000CCCCCCIIII00000CCCCCCIIII00000CCCCCCIIII00005555555H
CCCCCCIIII00000CCCCCCIII00000CCCCCIIII00000CCCCCCIIII00000CCCCCCIIII00
000CCCCCCIIII00000CCCCCCIIII00000CCCCCCIIII005GH5G5H5GH5G5HG5H5GH5G5H5
CCCCCCIIII00000CCCCCCIII00000CCCCCIIII00000CCCCCCIIII00HHHH5H5H5H5HHHH
000CCCCCCIIII00000CCCCCCIIII00000CCCCCCIIII00000CCCCCCIIII888888888888
CCCCCCIIII00000CCCCCCIII00000CCCCCIIII00000CCCCCCIIII00000CCCCCCIIII00
000CCCCCCIIII00000CCCCCCIIII00000CCCCCCIIII00000CCCCCCIIII00000CCCCCCI
CCCCCCIIII00000CCCCCCIII00000CCCCCIIII00000CCCCCCIIII00000CCCCCCIIII00
000CCCCCCIIII00000CCCCCCIIII00000CCCCCCIIII00000CCCCCCIIII00000CCCCCCI
CCCCCCIIII00000CCCCCCIII00000CCCCCIIII00000CCCCCCIIII00000CCCCCCIIII00
000CCCCCCIIII00000CCCCCCIIII00000CCCCCCIIII00000CCCCCCIIII00000CCCCCCI
CCCCCCIIII00000CCCCCCIII00000CCCCCIIII00000CCCCCCIIII00000CCCCCCIIII00
000CCCCCCIIII00000CCCCCCIIII00000CCCCCCIIII00000CCCCCCIIII00000CCCCCCI
CCCCCCIIII00000CCCCCCIII00000CCCCCIIII00000CCCCCCIIII00000CCCCCCIIII00
000CCCCCCIIII00000CCCCCCIIII00000CCCCCCIIII00000CCCCCCIIII00000CCCCCCI
CCCCCCIIII00000CCCCCCIII00000CCCCCIIII00000CCCCCCIIII00000CCCCCCIIII00
000CCCCCCIIII00000CCCCCCIIII00000CCCCCCIIII00000CCCCCCIIII00000CCCCCCI
CCCCCCIIII00000CCCCCCIII00000CCCCCIIII00000CCCCCCIIII00000CCCCCCIIII00
000CCCCCCIIII00000CCCCCCIIII00000CCCCCCIIII00000CCCCCCIIII00000CCCCCCI
CCCCCCIIII00000CCCCCCIII00000CCCCCIIII00000CCCCCCIIII00000CCCCCCIIII00
000CCCCCCIIII00000CCCCCCIIII00000CCCCCCIIII00000CCCCCCIIII00000CCCCCCI
OOOOOOOOOOOOOOOOOOOOOOOOOOOOOOOOOOOOOOOOOOOOOOOOOOOOOOOOOOOOOOOOOOOOOO
NNNNNNNNNNNNNNNNNNNNNNNNNNNNNNNNNNNNNNNNNNNNNNNNNNNNNNNNNNNNNNNNNNNNNN
NNNNNNNNNNNNNNNNNNNNNNNNNNNNNNNNNNNNNNNNNNNNNNNNNNNNNNNNNNNNNNNNNNNNNN
NNNNNNNNNNNNNNNNNNNNNNNNNNNNNNNNNNNNNNNNNNNNNNNNNNNNNNNNNNNNNNNNNNNNNN
NNNNNNNNNNNNNNNNNNNNNNNNNNNNNNNNNNNNNNNNNNNNNNNNNNNNNNNNNNNNNNNNNNNNNN
NNNNNNNNNNNNNNNNNNNNNNNNNNNNNNNNNNNNNNNNNNNNNNNNNNNNNNNNNNNNNNNNNNNNNN
NNNNNNNNNNNNNNNNNNNNNNNNNNNNNNNNNNNNNNNNNNNNNNNNNNNNNNNNNNNNNNNNNNNNNN