0000000IIIII00000000000000000IIIII7B55555555555555555HHHHHHH5555555555
000000IICC00000000000000000000III007B5555HHHHHHH5555555555555555555555
0000000CCCCIIIIIII000000FFFFFFFFFFFF7B555555555555555555555555HHHHHHHH
0CCCC00000CCCCCCIIII00000000000000III788855555555HHHHHHHHHHHHHHHHH5555
CCCC0000IIIIICCCCC000000000000IIIII000007B555GGGGGGGGGGGGG555555555555
00000000000IIIIIIIII0000000IIIIIIIII000004GGGGGGGGGGGGGGG55555HHHHHHHH
00000IIII000000III00000000IIIIIIIIIIII00045555555GGGGGGGGGGGG555HHHHHH
00ICCCC0000000000000IIIIIIIIIIII000000004E5555555GGGGGGGGG555555HHH555
000III0000FFFFFFFCCCC0IIIIII000000III004E555555GGGGG555555555555555555
00II000FFFFF0CCCCCCCCCCC00IIIIIIII00000455555555HHHHH55555555555A88888
000000FFFFFFIII00000CCCCCCC0000000000004555HHHHHHGGGGGGGGGG555556IIIFF
0FFFFFFF0IIIII0000I0000IIICCC0000IIII00788B555GGGGGGGGG5555555556IIIII
22222300II2222230000000000IIIIIIII00000000455555GGGGGGGGGHHHHHH56IIIII
555556III455555600II000000IIIII0000000IIII455555555GGGGG55555A8890IIII
55555D22E555555600000IIII000FFIIII00000004555555GGGGGG5555555600000000
5HHHHHHHH5GGGG5600IIII0000FFFF0000I0000II45555555GGGG55555555600000CCC
555555HHHHHHH55D222222222223FFFF000000II4E555HHHHHHHGG55555A8900FFFFFF
555GGGGGGGG55555555555555556FFFFFF0000004555555HHHHHHHHH555600FFIIIIII
55555555555GGGGG55555555555D22222222222E5555GGGGGHHHHHHHHHH600FIIIII00
55555555GGG555555555555GGGGGGG55555555555555555HHHHHHHH55556000FFIIIII
5HHHHHH5555555HHHHHH5555555HHHHHHHH5555555HH5555555555GGGGGD230FFFFFII
55555555555HHHH555555GGGGG5555555555555GGGGGGG5555555555555556FFFIIIII
888888B55555555555555555555555555555555555HHHHHHHH555555555556FFFFIIII
00IIII78888888888B5HHHHH555GGG55HHHHHHHH5555555555555555555A8900FFFFFF
00000IIIIII0000004555555555555555555555GGGGGGGGGGGGGGG555556II00000FFF
0000FF0II0000000078888B555555555HHHHHHHHH555555555A88888888900000II0IF
0FFFFFFFIIIIII0000000045555GGGGGGG55555555555555556FFFFFFFF00III00000F
000FFCCCCCCIIIII000000455555555GGGG55555A8888888889FFFF0CIII00000FFFFF
0000CCCCCIIII0FFFFF000455555GGGG5555555560II000FFFFFFFIIICC0000000000F
00CCC000IIIFFFFFF00000455GGGG5555HHHHH5560I000FFFFF00CCCCIIIII00I0000F
0000C00II0000000000III4555555GGGG555A88890000FFF000000CCCCCCCCCC0III00
00FFFFFF000FF0000000004555HHHHHHH5556000III0000FF000I000IIICCCCCCC0000
000000I00FCCFF00000III78B55555HHHH556000000II000I0000IIIIIIIIICCC000I0
0III000FCCCCFFFF0II0000078B55555555560III00000FFFF000000CCCCCC0000I000
0000IIIIIICCCCFFFFF0II000F78B555555560FFFFFFFCCFFFF0000CCCIIIIIIIII000
0000000IICCCFFFF00000000FFFF788888889000000CCCFFFF0000000FFFFF00000III
0000IICCCCCCC00FFFF00000000FFFFFFF0000000FFFCFF00000000FFFCCC0000II000
000000IIII0CCCC00FFFFFFF00000000000000FFFFFCCCCCFFFFFF00IIICCCC0000000
00000000IIII00CCCCCC00000000IIIIII0000000FFFFFF000000000000IIICC000000
OOOOOOOOOOOOOOOOOOOOOOOOOOOOOOOOOOOOOOOOOOOOOOOOOOOOOOOOOOOOOOOOOOOOOO
NNNNNNNNNNNNNNNNNNNNNNNNNNNNNNNNNNNNNNNNNNNNNNNNNNNNNNNNNNNNNNNNNNNNNN
NNNNNNNNNNNNNNNNNNNNNNNNNNNNNNNNNNNNNNNNNNNNNNNNNNNNNNNNNNNNNNNNNNNNNN
NNNNNNNNNNNNNNNNNNNNNNNNNNNNNNNNNNNNNNNNNNNNNNNNNNNNNNNNNNNNNNNNNNNNNN
NNNNNNNNNNNNNNNNNNNNNNNNNNNNNNNNNNNNNNNNNNNNNNNNNNNNNNNNNNNNNNNNNNNNNN
NNNNNNNNNNNNNNNNNNNNNNNNNNNNNNNNNNNNNNNNNNNNNNNNNNNNNNNNNNNNNNNNNNNNNN